#######################
#G  D B#$     $#R D  G#
## ##H###-#H#-###H## ##
#S $ H 2   H    1H $ A#
##H# ###H#####H### #H##
# HW    H  #  H    MH #
#######################